111111111111111
100000000000001
10P000000000001
100000000000001
100000000C00001
100000000000001
100000000C00001
100000000000001
10000000000E001
111111111111111