11111111111111111111111111111111111111
10000000000000000000000000000000000001
10P00000000000000000000000000000000001
10000000000000000000000000000000000001
100000000C0000000000000000000000000001
10000000000000000000000000000000000001
100000000C0000000000000000000000000001
10000000000000000000000000000000000001
10000000000000000000000000000000000001
10000000000000000000CC0000000000000001
10000000000CCCCCCCCCC00000000000000001
10000000000000000000C000000000CC000001
1000000000000000000CC00000000000000001
10000000000000000000000000000000000001
100000000000000000000000000000E0000001
10000000000000000000000000000000000001
10000000000000000000000000000000000001
100000000000000000011000000000K0000001
1000000000000000000C100000000000000001
11111111111111111111111111111111111111