111111111111111111111
100000000000000000001
10P000000000000000001
100000000000000000001
100000000C00000000001
100000000000000000001
100000000C00000000001
100000000000000000001
10000000000E000000001
10000000000E000000001
100000000000000000001
100000000000000000001
100000000000000000001
100000000000000000001
100000000000000000001
100000000000000000001
100000000000000000001
100000000000000000001
100000000000000000001
111111111111111111111