111111111111111
100000000000001
10P000000000001
100000000000001
100000000C00001
100000000000001
100000000C00001
100000000011111
10000000001E001
111111111111111