111111111111111
1000100001000C1
1P1010010101011
111010010101001
1C10100101011C1
100001010101101
111101010101001
1C0001010101011
1C00000100010E1
111111111111111