111111111111111
1C00100001000C1
1P1010010101011
111010010101001
101010010101101
100001010101101
111101C10101001
1C0001010101011
1C00000100010E1
111111111111111