1111111111111111111111111111
1000000000000000000000000001
10P0000000000000000000000001
1000000000000000000000000001
100000000C000000000000000001
1000000000000000000000000001
100000000C000000000000000001
1000000000000000000000000001
10000000000E0000000000000001
1000000000000000000000000001
1000000000000000000000000001
1000000000000000000000000001
1000000000000000000000000001
1000000000000000000000000001
1111111111111111111111111111