111111111111111111111111111111111111111
100000000000000000000000000000000000001
10P000000000000000000000000000000000001
100000000000000000000000000000000000001
100000000C00000000000000000000000000001
100000000000000000000000000000000000001
100000000C00000000000000000000000000001
100000000000000000000000000000000000001
100000000000000000000000000000000000001
10000000000000000000CC00000000000000001
10000000000CCCCCCCCCC000000000000000001
10000000000000000000C000000000CC0000001
1000000000000000000CC000000000000000001
100000000000000000000000000000000000001
100000000000000000000000000000E00000001
100000000000000000000000000000000000001
100000000000000000000000000000000000001
100000000000000000011000000000000000001
1000000000000000000C1000000000000000001
111111111111111111111111111111111111111