11111111111111111111
10000000000000000000
10P00000000000000000
10000000000000000000
100000000C0000000000
10000000000000000000
100000000C0000000000
10000000000000000000
10000000000E00000000
10000000000000000000
10000000000000000000
10000000000000000000
10000000000000000000
10000000000000000000
10000000000000000000
10000000000000000000
10000000000000000000
10000000000000000000
10000000000000000000
11111111111111111111